"filename", "language", "Java", "comment", "blank", "total"
"d:\eclipse-workspace\LianLianKan\bin\Base\Algr.class", "Java", 28, 0, 0, 28
"d:\eclipse-workspace\LianLianKan\bin\Base\Config.class", "Java", 9, 0, 0, 9
"d:\eclipse-workspace\LianLianKan\bin\Base\Point.class", "Java", 10, 0, 0, 10
"d:\eclipse-workspace\LianLianKan\bin\Base\Utils.class", "Java", 24, 0, 0, 24
"d:\eclipse-workspace\LianLianKan\bin\Frame\LLKListener.class", "Java", 50, 34, 0, 84
"d:\eclipse-workspace\LianLianKan\bin\Frame\MainJFrame$1.class", "Java", 12, 0, 0, 12
"d:\eclipse-workspace\LianLianKan\bin\Frame\MainJFrame$2.class", "Java", 11, 0, 0, 11
"d:\eclipse-workspace\LianLianKan\bin\Frame\MainJFrame$3.class", "Java", 10, 0, 0, 10
"d:\eclipse-workspace\LianLianKan\bin\Frame\MainJFrame$4.class", "Java", 11, 0, 0, 11
"d:\eclipse-workspace\LianLianKan\bin\Frame\MainJFrame.class", "Java", 65, 0, 0, 65
"d:\eclipse-workspace\LianLianKan\bin\Frame\PlayJPanel.class", "Java", 45, 0, 0, 45
"d:\eclipse-workspace\LianLianKan\bin\Frame\StartFrame$1.class", "Java", 14, 0, 0, 14
"d:\eclipse-workspace\LianLianKan\bin\Frame\StartFrame$2.class", "Java", 11, 0, 0, 11
"d:\eclipse-workspace\LianLianKan\bin\Frame\StartFrame$3.class", "Java", 11, 0, 0, 11
"d:\eclipse-workspace\LianLianKan\bin\Frame\StartFrame.class", "Java", 28, 0, 0, 28
"d:\eclipse-workspace\LianLianKan\bin\Frame\TimePanel$1.class", "Java", 17, 0, 1, 18
"d:\eclipse-workspace\LianLianKan\bin\Frame\TimePanel.class", "Java", 19, 0, 1, 20
"d:\eclipse-workspace\LianLianKan\src\Base\Algr.java", "Java", 76, 0, 10, 86
"d:\eclipse-workspace\LianLianKan\src\Base\Config.java", "Java", 14, 0, 10, 24
"d:\eclipse-workspace\LianLianKan\src\Base\Point.java", "Java", 10, 0, 2, 12
"d:\eclipse-workspace\LianLianKan\src\Base\Utils.java", "Java", 26, 3, 8, 37
"d:\eclipse-workspace\LianLianKan\src\Frame\LLKListener.java", "Java", 116, 12, 27, 155
"d:\eclipse-workspace\LianLianKan\src\Frame\MainJFrame.java", "Java", 111, 9, 16, 136
"d:\eclipse-workspace\LianLianKan\src\Frame\PlayJPanel.java", "Java", 72, 10, 16, 98
"d:\eclipse-workspace\LianLianKan\src\Frame\StartFrame.java", "Java", 50, 6, 10, 66
"d:\eclipse-workspace\LianLianKan\src\Frame\TimePanel.java", "Java", 40, 5, 8, 53
"Total", "-", 890, 79, 109, 1078